11111111111111111111
10000000000000000001
10001000000011110001
1000011100C010000001
1P00000000001E000001
11111111111111111111