11111111111111111111
1000000C000000000001
10001000000011100001
10000111000010000001
1P00000000001E000001
11111111111111111111
