11111111111111111111
1000000C0000000000C1
10001000000011100001
100001110000100C0001
1P0000000C001E000001
11111111111111111111
