11111
1P001
11001
1C001
11001
100E1
11111