11111111111111111
1C000C00C0C000C01
101C00C00C11000C1
10C11000C100C0C01
1P00C0C001E0000C1
11111111111111111

