11111111111111111
10000C0000C000001
101C0000001100001
100110000100C0001
1P0000C001E000001
11111111111111111

