11111
10P01
1C101
110E1
10001
11111
