111111
1C0001
101C01
10C111
1P00E1
111111
