1111111
1C00011
111C011
10C1111
1P01E11
1111111
